##############S#############
#                          #
#                          #
#                          #
#                          #
#                          #
#                          #
#                          #
#                          #
###############E############