###S###########
#   ###########
#             #
############  #
############  #
#####         #
######## ######
###           #
#   ###########
#             #
############  #
############  #
#####         #
#####E#########