#################################
#S        #                     #
######### # ##################  #
#         # ##################  #
# ######### ##################  #
#           #                   #
############# ###################                 
#             #E                #
# ############################# #
#          #                  # #
########## # ################ # #
#          #                # # #
# ######################### # # #
#                           #   #
#################################