###S####################
#   #########          #
#     m       m        #
############           #
###         m      m   #
#####                  #
#####E##################